The "CSS" column indicates in which CSS version the property is defined (CSS1, CSS2, or CSS3).

** Color Properties
Property	Description	CSS
color	Sets the color of text	CSS1
opacity	Sets the opacity level for an element	CSS3

** Background Properties
Property	Description	CSS
background	A shorthand property for setting all the background properties in one declaration	CSS1
background-attachment	Sets whether a background image is fixed or scrolls with the rest of the page	CSS1
background-blend-mode	Specifies the blending mode of each background layer (color/image)	CSS3 
background-color	Specifies the background color of an element	CSS1
background-image	Specifies one or more background images for an element	CSS1
background-position	Specifies the position of a background image	CSS1
background-repeat	Sets how a background image will be repeated	CSS1
background-clip	Specifies the painting area of the background	CSS3
background-origin	Specifies where the background image(s) is/are positioned	CSS3
background-size	Specifies the size of the background image(s)	CSS3

** Border Properties
Property	Description	CSS
border	Sets all the border properties in one declaration	CSS1
border-bottom	Sets all the bottom border properties in one declaration	CSS1
border-bottom-color	Sets the color of the bottom border	CSS1 
border-bottom-left-radius	Defines the shape of the border of the bottom-left corner	CSS3
border-bottom-right-radius	Defines the shape of the border of the bottom-right corner	CSS3
border-bottom-style	Sets the style of the bottom border	CSS1
border-bottom-width	Sets the width of the bottom border	CSS1
border-color	Sets the color of the four borders	CSS1
border-image	A shorthand property for setting all the border-image-* properties	CSS3
border-image-outset	Specifies the amount by which the border image area extends beyond the border box	CSS3
border-image-repeat	Specifies whether the border image should be repeated, rounded or stretched	CSS3
border-image-slice	Specifies how to slice the border image	CSS3
border-image-source	Specifies the path to the image to be used as a border	CSS3
border-image-width	Specifies the widths of the image-border	CSS3
border-left	Sets all the left border properties in one declaration	CSS1
border-left-color	Sets the color of the left border	CSS1
border-left-style	Sets the style of the left border	CSS1
border-left-width	Sets the width of the left border	CSS1
border-radius	A shorthand property for setting all the four border-*-radius properties	CSS3
border-right	Sets all the right border properties in one declaration	CSS1
border-right-color	Sets the color of the right border	CSS1
border-right-style	Sets the style of the right border	CSS1
border-right-width	Sets the width of the right border	CSS1
border-style	Sets the style of the four borders	CSS1
border-top	Sets all the top border properties in one declaration	CSS1
border-top-color	Sets the color of the top border	CSS1
border-top-left-radius	Defines the shape of the border of the top-left corner	CSS3
border-top-right-radius	Defines the shape of the border of the top-right corner	CSS3
border-top-style	Sets the style of the top border	CSS1
border-top-width	Sets the width of the top border	CSS1
border-width	Sets the width of the four borders	CSS1

** Basic Box Properties
Property	Description	CSS
bottom	Specifies the bottom position of a positioned element	CSS2
clear	Specifies which sides of an element where other floating elements are not allowed	CSS1
clip	Clips an absolutely positioned element	CSS2
display	Specifies how a certain HTML element should be displayed	CSS1
float	Specifies whether or not a box should float	CSS1
height	Sets the height of an element	CSS1
left	Specifies the left position of a positioned element	CSS2
margin	Sets all the margin properties in one declaration	CSS1
margin-bottom	Sets the bottom margin of an element	CSS1
margin-left	Sets the left margin of an element	CSS1
margin-right	Sets the right margin of an element	CSS1
margin-top	Sets the top margin of an element	CSS1
max-height	Sets the maximum height of an element	CSS2
max-width	Sets the maximum width of an element	CSS2
min-height	Sets the minimum height of an element	CSS2
min-width	Sets the minimum width of an element	CSS2
overflow	Specifies what happens if content overflows an element's box	CSS2
overflow-x	Specifies whether or not to clip the left/right edges of the content, if it overflows the element's content area	CSS3
overflow-y	Specifies whether or not to clip the top/bottom edges of the content, if it overflows the element's content area	CSS3
padding	Sets all the padding properties in one declaration	CSS1
padding-bottom	Sets the bottom padding of an element	CSS1
padding-left	Sets the left padding of an element	CSS1
padding-right	Sets the right padding of an element	CSS1
padding-top	Sets the top padding of an element	CSS1
position	Specifies the type of positioning method used for an element (static, relative, absolute or fixed)	CSS2
right	Specifies the right position of a positioned element	CSS2
top	Specifies the top position of a positioned element	CSS2
visibility	Specifies whether or not an element is visible	CSS2
width	Sets the width of an element	CSS1
vertical-align	Sets the vertical alignment of an element	CSS1
z-index	Sets the stack order of a positioned element	CSS2

** Flexible Box Layout
Property	Description	CSS
align-content	Specifies the alignment between the lines inside a flexible container when the items do not use all available space	CSS3
align-items	Specifies the alignment for items inside a flexible container	CSS3
align-self	Specifies the alignment for selected items inside a flexible container	CSS3
flex	Specifies the length of the item, relative to the rest	CSS3
flex-basis	Specifies the initial length of a flexible item	CSS3
flex-direction	Specifies the direction of the flexible items	CSS3
flex-flow	A shorthand property for the flex-direction and the flex-wrap properties	CSS3
flex-grow	Specifies how much the item will grow relative to the rest	CSS3
flex-shrink	Specifies how the item will shrink relative to the rest	CSS3
flex-wrap	Specifies whether the flexible items should wrap or not	CSS3
justify-content	Specifies the alignment between the items inside a flexible container when the items do not use all available space	CSS3
order	Sets the order of the flexible item, relative to the rest	CSS3

** Text Properties
Property	Description	CSS
hanging-punctuation	Specifies whether a punctuation character may be placed outside the line box	CSS3
hyphens	Sets how to split words to improve the layout of paragraphs	CSS3
letter-spacing	Increases or decreases the space between characters in a text	CSS1
line-break	Specifies how/if to break lines	CSS3
line-height	Sets the line height	CSS1
overflow-wrap	Specifies whether or not the browser may break lines within words in order to prevent overflow (when a string is too long to fit its containing box)	CSS3
tab-size	Specifies the length of the tab-character	CSS3
text-align	Specifies the horizontal alignment of text	CSS1
text-align-last	Describes how the last line of a block or a line right before a forced line break is aligned when text-align is "justify"	CSS3
text-combine-upright	Specifies the combination of multiple characters into the space of a single character	CSS3
text-indent	Specifies the indentation of the first line in a text-block	CSS1
text-justify	Specifies the justification method used when text-align is "justify"	CSS3
text-transform	Controls the capitalization of text	CSS1
white-space	Specifies how white-space inside an element is handled	CSS1
word-break	Specifies line breaking rules for non-CJK scripts	CSS3
word-spacing	Increases or decreases the space between words in a text	CSS1
word-wrap	Allows long, unbreakable words to be broken and wrap to the next line	CSS3

** Text Decoration Properties
Property	Description	CSS
text-decoration	Specifies the decoration added to text	CSS1
text-decoration-color	Specifies the color of the text-decoration	CSS3
text-decoration-line	Specifies the type of line in a text-decoration	CSS3
text-decoration-style	Specifies the style of the line in a text decoration	CSS3
text-shadow	Adds shadow to text	CSS3
text-underline-position	Specifies the position of the underline which is set using the text-decoration property	CSS3

** Font Properties
Property	Description	CSS
@font-face	A rule that allows websites to download and use fonts other than the "web-safe" fonts	CSS3
@font-feature-values	Allows authors to use a common name in font-variant-alternate for feature activated differently in OpenType	CSS3
font	Sets all the font properties in one declaration	CSS1
font-family	Specifies the font family for text	CSS1
font-feature-settings	Allows control over advanced typographic features in OpenType fonts	CSS3
font-kerning	Controls the usage of the kerning information (how letters are spaced)	CSS3
font-language-override	Controls the usage of language-specific glyphs in a typeface	CSS3
font-size	Specifies the font size of text	CSS1
font-size-adjust	Preserves the readability of text when font fallback occurs	CSS3
font-stretch	Selects a normal, condensed, or expanded face from a font family	CSS3
font-style	Specifies the font style for text	CSS1
font-synthesis	Controls which missing typefaces (bold or italic) may be synthesized by the browser	CSS3
font-variant	Specifies whether or not a text should be displayed in a small-caps font	CSS1
font-variant-alternates	Controls the usage of alternate glyphs associated to alternative names defined in @font-feature-values	CSS3
font-variant-caps	Controls the usage of alternate glyphs for capital letters	CSS3
font-variant-east-asian	Controls the usage of alternate glyphs for East Asian scripts (e.g Japanese and Chinese)	CSS3
font-variant-ligatures	Controls which ligatures and contextual forms are used in textual content of the elements it applies to	CSS3
font-variant-numeric	Controls the usage of alternate glyphs for numbers, fractions, and ordinal markers	CSS3
font-variant-position	Controls the usage of alternate glyphs of smaller size positioned as superscript or subscript regarding the baseline of the font	CSS3
font-weight	Specifies the weight of a font	CSS1

** Writing Modes Properties
Property	Description	CSS
direction	Specifies the text direction/writing direction	CSS2
text-orientation	Defines the orientation of the text in a line	CSS3
text-combine-upright	Specifies the combination of multiple characters into the space of a single character	CSS3
unicode-bidi	Used together with the direction property to set or return whether the text should be overridden to support multiple languages in the same document	CSS2
user-select	Specifies whether the text of an element can be selected	CSS3
writing-mode		CSS3

** Table Properties
Property	Description	CSS
border-collapse	Specifies whether or not table borders should be collapsed	CSS2
border-spacing	Specifies the distance between the borders of adjacent cells	CSS2
caption-side	Specifies the placement of a table caption	CSS2
empty-cells	Specifies whether or not to display borders and background on empty cells in a table	CSS2
table-layout	Sets the layout algorithm to be used for a table	CSS2

** Lists and Counters Properties
Property	Description	CSS
counter-increment	Increments one or more counters	CSS2
counter-reset	Creates or resets one or more counters	CSS2
list-style	Sets all the properties for a list in one declaration	CSS1
list-style-image	Specifies an image as the list-item marker	CSS1
list-style-position	Specifies if the list-item markers should appear inside or outside the content flow	CSS1
list-style-type	Specifies the type of list-item marker	CSS1

** Animation Properties
Property	Description	CSS
@keyframes	Specifies the animation code	CSS3
animation	A shorthand property for all the animation properties (except animation-play-state and animation-fill-mode)	CSS3
animation-delay	Specifies a delay for the start of an animation	CSS3
animation-direction	Specifies whether or not the animation should play in reverse on alternate cycles	CSS3
animation-duration	Specifies how many seconds or milliseconds an animation takes to complete one cycle	CSS3
animation-fill-mode	Specifies a style for the element when the animation is not playing (when it is finished, or when it has a delay)	CSS3
animation-iteration-count	Specifies the number of times an animation should be played	CSS3
animation-name	Specifies the name of the @keyframes animation	CSS3
animation-play-state	Specifies whether the animation is running or paused	CSS3
animation-timing-function	Specifies the speed curve of an animation	CSS3

** Transform Properties
Property	Description	CSS
backface-visibility	Defines whether or not an element should be visible when not facing the screen	CSS3
perspective	Specifies the perspective on how CSS3D elements are viewed	CSS3
perspective-origin	Specifies the bottom position of CSS3D elements	CSS3
transform	Applies a CSS2D or CSS3D transformation to an element	CSS3
transform-origin	Allows you to change the position on transformed elements	CSS3
transform-style	Specifies how nested elements are rendered in CSS3D space	CSS3

** Transitions Properties
Property	Description	CSS
transition	A shorthand property for setting the four transition properties	CSS3
transition-property	Specifies the name of the CSS property the transition effect is for	CSS3
transition-duration	Specifies how many seconds or milliseconds a transition effect takes to complete	CSS3
transition-timing-function	Specifies the speed curve of the transition effect	CSS3
transition-delay	Specifies when the transition effect will start	CSS3

** Basic User Interface Properties
Property	Description	CSS
box-shadow	Attaches one or more drop-shadows to the box	CSS3
box-sizing	Tells the browser what the sizing properties (width and height) should include	CSS3
content	Used with the :before and :after pseudo-elements, to insert generated content	CSS2
cursor	Specifies the type of cursor to be displayed	CSS2
ime-mode	Controls the state of the input method editor for text fields	CSS3
outline	Sets all the outline properties in one declaration	CSS2
outline-color	Sets the color of an outline	CSS2
outline-offset	Offsets an outline, and draws it beyond the border edge	CSS3
outline-style	Sets the style of an outline	CSS2
outline-width	Sets the width of an outline	CSS2
resize	Specifies whether or not an element is resizable by the user	CSS3
text-overflow	Specifies what should happen when text overflows the containing element	CSS3

** Multi-column Layout Properties
Property	Description	CSS
break-after	Specifies the page-, column-, or region-break behavior after the generated box	CSS3
break-before	Specifies the page-, column-, or region-break behavior before the generated box	CSS3
break-inside	Specifies the page-, column-, or region-break behavior inside the generated box	CSS3
column-count	Specifies the number of columns an element should be divided into	CSS3
column-fill	Specifies how to fill columns	CSS3
column-gap	Specifies the gap between the columns	CSS3
column-rule	A shorthand property for setting all the column-rule-* properties	CSS3
column-rule-color	Specifies the color of the rule between columns	CSS3
column-rule-style	Specifies the style of the rule between columns	CSS3
column-rule-width	Specifies the width of the rule between columns	CSS3
column-span	Specifies how many columns an element should span across	CSS3
column-width	Specifies the width of the columns	CSS3
columns	A shorthand property for setting column-width and column-count	CSS3
widows	Sets the minimum number of lines that must be left at the top of a page when a page break occurs inside an element	CSS2

** Paged Media
Property	Description	CSS
box-decoration-break	Sets the behaviour of the background and border of an element at page-break, or, for in-line elements, at line-break.	CSS3
orphans	Sets the minimum number of lines that must be left at the bottom of a page when a page break occurs inside an element	CSS2
page-break-after	Sets the page-breaking behavior after an element	CSS2
page-break-before	Sets the page-breaking behavior before an element	CSS2
page-break-inside	Sets the page-breaking behavior inside an element	CSS2

** Generated Content for Paged Media
Property	Description	CSS
marks	Adds crop and/or cross marks to the document	CSS3
quotes	Sets the type of quotation marks for embedded quotations	CSS2
Filter Effects Properties
Property	Description	CSS
filter	Defines effects (e.g. blurring or color shifting) on an element before the element is displayed	CSS3

** Image Values and Replaced Content
Property	Description	CSS
image-orientation	Specifies a rotation in the right or clockwise direction that a user agent applies to an image (This property is likely going to be deprecated and its functionality moved to HTML)	CSS3
image-rendering	Gives a hint to the browser about what aspects of an image are most important to preserve when the image is scaled	CSS3
image-resolution	Specifies the intrinsic resolution of all raster images used in/on the element	CSS3
object-fit	Specifies how the contents of a replaced element should be fitted to the box established by its used height and width	CSS3
object-position	Specifies the alignment of the replaced element inside its box	CSS3

** Masking Properties
Property	Description	CSS
mask		CSS3
mask-type		CSS3

** Speech Properties
Property	Description	CSS
mark	A shorthand property for setting the mark-before and mark-after properties	CSS3
mark-after	Allows named markers to be attached to the audio stream	CSS3
mark-before	Allows named markers to be attached to the audio stream	CSS3
phonemes	Specifies a phonetic pronunciation for the text contained by the corresponding element	CSS3
rest	A shorthand property for setting the rest-before and rest-after properties	CSS3
rest-after	Specifies a rest or prosodic boundary to be observed after speaking an element's content	CSS3
rest-before	Specifies a rest or prosodic boundary to be observed before speaking an element's content	CSS3
voice-balance	Specifies the balance between left and right channels	CSS3
voice-duration	Specifies how long it should take to render the selected element's content	CSS3
voice-pitch	Specifies the average pitch (a frequency) of the speaking voice	CSS3
voice-pitch-range	Specifies variation in average pitch	CSS3
voice-rate	Controls the speaking rate	CSS3
voice-stress	Indicates the strength of emphasis to be applied	CSS3
voice-volume	Refers to the amplitude of the waveform output by the speech synthesises	CSS3
